5 10  
##########
#        #
#   O    #
#        #
##########